accelerating-gradient=accelerating.?gradient.?
acceleration=acceleration.?
accelerator-theory=accelerator.?theory.?
accumulation=accumulation.?
alignment=alignment.?
antiproton=antiproton.?
background=background.?
beam-beam-effects=beam.?beam.?effect.?
beam-cooling=beam.?cooling.?
beam-diagnostic=beam.?diagnostic.?
beam-loading=beam.?loading.?
beam-losses=beam.?loss[es|].?
beam-transport=beam.?transport.?
beat-wave=beat.?wave.?
betatron=betatron.?
booster=booster.?
brightness=brightness.?
brilliance=brilliance.?
bunching=bunching.?
cathode=cathode.?
cavity=cavit[y|ies].?
chromatic-effects=chromatic.?effect.?
civil-engineering=civil.?engineering.?
closed-orbit=closed.?orbit.?
coherent-effects=coherent.?effect.?
collective-effects=collective.?effect.?
collider=collider.?
collimation=collimation.?
controls=control.?
CORBA=CORBA.?
coupling=coupling.?
cryogenics=cryogenic.?
cryomodule=cryomodule.?
cyclotron=cyclotron.?
damping=damping.?
data-acquisition=data.?acquisition.?
data-analysis=data.?analysis.?
database=database.?
data-management=data.?management.?
detector=detector.?
device-server=device.?server.?
diagnostics=diagnostic.?
dipole=dipole.?
distributed=distributed.?
Domain-Specific-Languages=Domain.?Specific.?Language.?
drift-tube-linac=drift.?tube.?linac.?
DSL=DSL.?
DTL=DTL.?
dumping=dumping.?
dynamic-aperture=dynamic.?aperture.?
ECR=ECR.?
ECRIS=ECRIS.?
electromagnetic-fields=electromagnetic.?field.?
electron=electron.?
electronics=electronics.?
electrostatic-devices=electrostatic.?device.?
embedded=embedded.?
emittance=emittance.?
energy-calibration=energy.?calibration.?
EPICS=EPICS.?
Ethernet=Ethernet.?
experiment=experiment.?
extraction=extraction.?
factory=factor[y|ies].?
feedback=feedback.?
FEL=FEL.?
FEM=FEM.?
FFAG=FFAG.?
fibre-optics=fibre.?optic.?
flattop=flat.?top.?
focusing=focusing.?
FPGA=FPGA.?
framework=framework.?
free-electron-laser=free.?electron.?laser.?
fuzzy set=fuzzy.?set.?
GPU=GPU.?
ground-motion=ground.?motion.?
GUI=gui.?
GUI=GUI.?
gun=gun.?
hadrontherapy=hadron.?therapy.?
hadron=hadron.?
hardware=hardware.?
heavy-ion=heavy.?ion.?
higher-order-mode=higher.?order.?mode.?
high-level-rf=high.?level.?rf.?
high-voltage=high.?voltage.?
HLRF=HLRF.?
H-minus=H.?minus.?
HOM=HOM.?
impedance=impedance.?
incoherent-effects=incoherent.?effect.?
induction=induction.?
industrial-accelerators=industrial.?accelerator.?
injection=injection.?
insertion=insertion.?
insertion-device=insertion.?device.?
instrumentation=instrumentation.?
interaction-region=interaction.?region.?
interface=interface.?
interlocks=interlocks.?
inverse-free-electron-laser=inverse.?free.?electron.?laser.?
ion-effects=ion.?effect.?
ion-source=ion.?source.?
ISAC=ISAC.?
ISOL=ISOL.?
isotope-production=isotope.?production.?
kaon=kaon.?
kicker=kicker.?
klystron=klystron.?
LabView=lab.?view.?
laser=laser.?
lattice=lattice.?
LEBT=LEBT.?
lepton=lepton.?
light-ion=light.?ion.?
linac=linac.?
linear-collider=linear.?collider.?
linear-dynamics=linear.?dynamics.?
Linux=Linux.?
LLRF=LLRF.?
longitudinal-dynamics=longitudinal.?dynamics.?
low-level-rf=low.?level.?rf.?
luminosity=luminosity.?
machine-acceptance=machine.?acceptance.?
machine-protect=machine.?protect.?
magnet-design=magnet.?design.?
man-machine-interface=man.?machine.?interface.?
MEBT=MEBT.?
medical-accelerators=medical.?accelerator.?
micro-particles=micro.?particle.?
microtron=microtron.?
MMI=MMI.?
monitoring=monitoring.?
multi-bunch-effects=multi.?bunch.?effect.?
multipactoring=multipact[or|oring].?
multipole=multipole.?
network=network.?
neutral-beams=neutral.?beam.?
neutron=neutron.?
niobium=niobium.?
non-linear-dynamics=non.linear.?dynamics.?
octupole=octupole.?
operation=operation.?
operational-performance=operational.?performance.?
optical-matching=optical.?matching.?
optics=optics.?
permanent-magnet=permanent.?magnet.?
photon=photon.?
pick-up=pick.?up.?
plasma=plasma.?
PLC=plc.?
polarization=polari[s|z]ation.?
positron=positron.?
power-supply=power.?suppl[y|ies].?
project-management=project.?management.?
proton=proton.?
pulsed-power=pulsed.?power.?
pulse-stretcher=pulse.?stretcher.?
quadrupole=quadrupole.?
radiation=radiation.?
radioactivity=radioactivity.?
radio-frequency=radio.?frequency.?
radio-frequency-quadrupole=radio.?frequency.?quadrupole.?
real-time=real.?time.?
recirculation=recirculation.?
remote-handling=remote.?handling.?
resonance=resonance.?
rf-amplifier=rf.?amplifier.?
rfq=rfq.?
RF-structure=RF.?structure.?
SCADA=scada.?
scattering=scattering.?
secondary-beams=secondary.?beam.?
separation-scheme=separation.?scheme.?
septum=septum.?
sextupole=sextupole.?
shielding=shielding.?
simulation=simulation.?
single-bunch=single.?bunch[es|]
site=site.?
software=software.?
software-architecture=software.?architecture.?
software-component=software.?component.?
software-security=software.?securit(y|ies|)
software-standard=software.?standard.?
software-tool=software.?tool.?
software-virus=software.?virus[es|]
solenoid=solenoid.?
space-charge=space.?charge.?
SRF=SRF.?
status=status.?
storage-ring=storage.?ring.?
superconducting-cavity=super.?conducting.?cavit[y|ies].?
superconducting-magnet=super.?conducting.?magnet.?
superconducting-RF=super.?conducting.?RF.?
superconductivity=super.?conductivity.?
survey=survey.?
synchro-cyclotron=synchro.?cyclotron.?
synchrotron=synchrotron.?
synchrotron-radiation=synchrotron.?radiation.?
tandem-accelerator=tandem.?accelerator.?
TANGO=TANGO.?
target=target.?
timing=timing.?
toolkit=toolkit.?
transverse-dynamics=transverse.?dynamics.?
undulator=undulator.?
vacuum=vacuum.?
Van-der-Graaf=Van.?der.?Graaf.?
wakefield=wake.?field.?
wiggler=wiggler.?
Windows=Windows.?
